...............#................#................#........#.....................#.................
...............#................#................#........#.....................#.................
...............#...........##########............#........##########............#.................
####.#####.....#................#................#..........................###########...........
.........#............#.........#................#.......#......................#.................
.........#............#....................#.............#........#######.......#.................
.........#####........#....................#.............#............#..................#########
.....#...#............#....................#.............#............#..................#........
.....#...#............#......####..........#.......####..#............#..................#........
.....#.........#......#.........#..........#....................#.....#########..........#........
.....#.........#................#..........#....................#..........#......................
.....#.........#.............#########.##########........##########........#......................
.....#.........#................................................#..........#......################
######.........#....................#...........................#..........#......#...............
...............#....................#.........#####..#..........#.................#...............
....................................#................#..........#.................#...............
........................#...........#................#............................#...............
##########..............########........#####........#............................#......#########
........................#...................#........#..............#.............#...............
....########.........................................########.......#.............................
...........###########......................#.......................#.............................
............................#####..........................#........#########.....................
.......................................##########..........#........#.................#...........
.............#.........................#...................#........#.................#...........
.............#............#............#...................#........#.................#...........
.............#............#.................##########.....#................#######...#...........
.............#.....#############.......#.......................#............#.........#......#####
####..#########...........#............#.......................#..####......#.........#...........
..........................#............#............#######....#............#.........#...........
.............#............#............#................#......#............#.........#...........
.............#..........................................#......#............####################..
............................#####.......................#......#................#.................
......#..........#.............#.......##############..........#................#.................
###########......#......#......#................................................#.................
......#..........#......#......#........................#...............#.......#.................
......#..........#......#......#.................###########............#.......#.................
......#..........#......#..................#............#...............#.......#..........#######
....#####........########.............#.................#...............#..................#......
........................#.......#.....#.................#....########...#..................#......
........................#.......#.....#.............#####..............#############..............
................................#.....#.................#.........................................
............................#...##########.............................#.................#####....
#############...............#......................................#######........................
.........#..................#..........................#...............#.........#................
.........#..................#.........#.......#############............#.........#............#...
.....###########...#######............#................#...............#.........#............#...
.........#............................#................#...............#......................#...
........................#.............#................#......................................#...
........................#.............#............#...#.....#####..##..............###########...
.........#..............#.............#............#..........................................##..
##########..............#..........................#...........................................#..
.........#..............########...................#...........................................#..
.........#..................############......................#.......#########...##########......
............................................................................#.....................
..#........................................................#................#.....................
...........................................#######.####....#................#.....................
........################...................................#................#.....................
.......................#...................................#................#.....................
..##...................#.......#####.......................#......#################...........#...
#####...........#......#................############.......#..................................#...
................#......#................#.....................................................#...
................#......#................#.........................#................#..........####
............##########.....######.......#.........................#................#..........#...
................................#.......#..........................................#..........#...
###.............................#...............#####..............................#..........#...
................................#...................#.........#..######.......................#...
.....#..........................#...................#.............############....................
.....#.....................######...................#...................#.........................
...#######..............................#####...........................#..............##########.
................................................#.......................#.......#......#..........
.................##########...............#.....#..............########.#.......#......#..........
.......#.........#........................#.....#.......................#.......#......#..........
.......#.........#........................#...........###...............#.......#......#..........
.......#.........#........................#...........###.......................#......#..........
.......#.........#...............##.........................#...................#..........###....
########........########.........##.........................#............######.#.................
.................................................#..........#...............#...........#.........
...........#.........##########.......#..........#..........#...............#...........#.........
...........#..........................#..........#..........#...........................#.........
...........#..........................#..........#........################..............#.........
..................#....#...............#..................#####...#.......#..#....................
..............#####....#...............#..#....###....##..........#.......#..#....................
...######.........#....#...............########...................#.......#.......................
...#..............#.......................#...............................#...........#####.......
...#..............#.......................#...............................#.......................
...#..............#.......................#...............................#.......................
...#..............#...................#######.............................#......##########.....#.
...#.......................................................######...............................#.
...#.#####...#...........########.....................................................#..#......#.
...#.....########.....................................................................#..#......#.
.............#.......................#....#.........##########.....................#..#..#......#.
.......########......................#....#........................................#..#..#......#.
.............#.................#.....#....#........................................#..#..#......#.
.............#.................#.....#....#........................................#..#.........#.
.............###########.......#.....#....#............######......................#..#...........
....########.#..######.........#.....#....#........................................#..#...........
.............#.................#.....#....##########...............................#..............
.............#.................#.....#....#........................................#............#.
.............######............#.....#....#....#####.................#######....................#.
......................########.#..........#.....................................................#.
...............................#................................................................#.
